O S O O O O B B
B O O O B O B O
O O O B O O O O
O B O O O B O B
O B O B O B G O
O O O O O O O B